1 120
WWWWWWWW
WP  W  W
W F W  W
W 4 WG W
W   S  W
W 3  G W
WWWWWWWW
